The 48 Laws of Power - Robert Greene
The Art of Seduction - Robert Greene
Mastery - Robert Greene
The 33 Strategies of War - Robert Greene
The 7 Habits of Highly Effective People - Stephen R. Covey
How to Win Friends and Influence People - Dale Carnegie
Think and Grow Rich - Napoleon Hill
The Power of Positive Thinking - Norman Vincent Peale
The Alchemist - Paulo Coelho
The Four Agreements - Don Miguel Ruiz
The Subtle Art of Not Giving a F*ck - Mark Manson
Atomic Habits - James Clear
The Power of Now - Eckhart Tolle
The 5 Second Rule - Mel Robbins
Mindset: The New Psychology of Success - Carol S. Dweck
The Obstacle Is the Way - Ryan Holiday
Ego Is the Enemy - Ryan Holiday
The 4-Hour Work Week - Timothy Ferriss
The Richest Man in Babylon - George S. Clason
The Power of Habit - Charles Duhigg
The Art of War - Sun Tzu
The Prince - Niccol√≤ Machiavelli
Rich Dad Poor Dad - Robert Kiyosaki
The 5 Love Languages - Gary Chapman
The Happiness of Pursuit - Chris Guillebeau
The Compound Effect - Darren Hardy
Outliers - Malcolm Gladwell
The Magic of Thinking Big - David J. Schwartz
The War of Art - Steven Pressfield
Awaken the Giant Within - Tony Robbins
The Road Less Traveled - M. Scott Peck
The Power of Your Subconscious Mind - Joseph Murphy
Man's Search for Meaning - Viktor E. Frankl
Emotional Intelligence - Daniel Goleman
The 10X Rule - Grant Cardone
The Power of Intention - Wayne W. Dyer
Who Moved My Cheese? - Spencer Johnson
The Wisdom of Insecurity - Alan Watts
